11111110000000000111
11111110000000000111
11111110011111100111
11111110011111100111
11111110011111100111
11111110011111100111
11111110011111100111
00000000011111100111
00000000011111100111
11111111111111100111
11111111111111100111
10000000000000000111
10000000000000000111
10011111111111111111
10011111111110000001
10001100001110111001
11101101101110111001
11100001100000111001
11111111111111111001
11111111111111111001

